1 1 1 1 1
1 3 3 3 1
1 3 4 3 1
1 3 3 3 1
1 1 1 1 1
